
// Main Menu Detail

SettingsText = paramètres
MoreGamesText = Plus de jeux
RateUsText = évaluez nous!!!
PlayText = Jouer
ScoreText = But
ExitText = Sortie
BackText = arrière

MoreFunText = plus amusant
QuestText = Quête
FreeSpinText = Tour gratuit
ShopText = Boutique
FreeCashText = gratuit le fric
FreeGoldText = or gratuit
PrimaryWeaponText = Arme principale
MissionText = Mission
NextText = Prochain
BuyText= Acheter
MissionSelectionText = MISSION DE SÉLECTION
LevelSelectionText= SÉLECTION DE NIVEAU

// Extra Button

HomeText=Accueil
ResumeText=CV
ReplayText=Rejouer
ShareText=Partager
HotGamesText=jeux chauds
LoadingText=Chargement
StartRecordingText=Commencer lenregistrement
StopText=Arrêtez
ShowRecordingText=Voir enregistrement


//Other Button Text

LevelClearText= Niveau Effacer
PauseText=le repos
LevelCompleteText=Niveau complet
LevelFailText=Niveau Fail
MissionFailText= Niveau Fail
MissionCompleteText=Mission accomplie
GameOverText= Jeu terminé
SpinTheWheelText=Tourne la roue
	//LEVEL SELECTION DETAIL TEXT

	ObjectiveText = OBJECTIF!!!
	LevelText= Niveau
	





  //Quit Panel Text

 QuitText = Quitter
 QuitDescriptionText = Êtes-vous sûr?
 NoText = Non
 YesText = Oui 


// Settings Panel Text

MusicText = La musique
SoundText = Sonner
SensitivityText = Sensibilité


//Quest Text

AchievementText = Exploit
DailyTaskText = Tâche quotidienne
	//Achievement
	EnemyTargetsText = Les cibles ennemies


	CompleteLevelText= Niveau complet
	

	EnemiesText = Ennemis


	DailyBonusText = Bonus quotidien


	TimeText = Temps
	

	ClearLevelText = Effacer Level
	

	ClearMissionText = Effacer Mission



	 EnemyTargetsText = Les cibles ennemies
	 EnemyTargetsDescriptionText = Eliminates 10 Enemies


//free spin text

SpinText = Tourner

FreeText = Gratuit



//shops detail text

GunText = Pistolet
MedicalKitsText = trousses médicales
ShieldText = BOUCLIER
GoldText = OR
CashText = argent liquide

	//gun detail text

	PistolText = Pistolet
	RifleText= Fusil
	ShotGunText = Fusil à pompe
	RPGText = RPG
	SniperText = Tireur d'élite
	GrenadeLauncherText = Lance-grenades

	//GUNS PROPERTIES TEXT
		ClipSizeText= taille du clip
		DamageText = Dommage
		ReloadTimeText = Temps de rechargement
		FireRateText=Cadence de tir

	//Medical kits

	PacksText = paquets

	//shield detail text

	HealthText = Santé

	//gold detail text

	CountText = compter

MissileText = MISSILES
AirStrikeText = GRÈVE DE L'AIR
EquipText = ÉQUIPER
EquipedText = EQUIPEE
CollectText = COLLECTE
DayText = JOUR
UpgradeText = Surclassement
LoadingText = CHARGEMENT
TapToContinueText = Tap Pour Continuer
PausedText = Pasued!!!
WatchVideoText = Regarder la vidéo
RestartText = Redémarrer
StoreText = boutique
WatchLevelVideosText = Montre Niveau Vidéos
RewardVideoText = Récompense Vidéo
TopGamesText = TOP JEUX
RemoveAdsText = Supprimer annonces
ClaimText = REVENDICATION
ClaimedText = REVENDICATIONS

Oktext = D'accord
CancelText = ANNULER
RetryText = RECOMMENCEZ!!!

CongratulationText = FELICITATIONS
SniperXText = Tireur d'élite X
ContinueText = Continuer


LevelCompletedText=Niveau complet!!!
LevelFailedText=Niveau Fail!!!
MissionFailedText= Niveau Fail!!!
MissionCompletedText=Mission accomplie!!!


ObjectiveDescription2Text = clair dans le temps cible
ObjectiveDescription3Text = Plus de 50% de la santé