// Main Menu Detail

SettingsText = Einstellungen
MoreGamesText = Mehr Spiele
RateUsText = bewerten Sie uns!!!
PlayText = Spielen
ScoreText = Ergebnis
ExitText = Ausgang
BackText = Zurück



MoreFunText = Mehr Spaß
QuestText = Suche
FreeSpinText = Frei drehen

ShopText = Geschäft
FreeCashText = Frei Kasse
FreeGoldText = Geld
PrimaryWeaponText = Primärwaffe
MissionText = die Aufgabe
NextText = Nächster
BuyText=Kaufen
MissionSelectionText = Missionsauswahl
LevelSelectionText= Ebene Auswahl


// Extra Button

HomeText=Zuhause
ResumeText=Fortsetzen
ReplayText=Wiederholung
ShareText=Aktie
HotGamesText=heiße Spiele
LoadingText=Laden
StartRecordingText=Starte die Aufnahme
StopText=Halt
ShowRecordingText=Show Aufnahme


//Other Button Text

LevelClearText= Ebene löschen
PauseText=Pause
LevelCompleteText=Level geschafft
LevelFailText=Stufe Ausfallen
MissionFailText= Mission scheitern
MissionCompleteText=Mission abgeschlossen
GameOverText= Spiel ist aus
SpinTheWheelText=Drehe das Rad
	//LEVEL SELECTION DETAIL TEXT

	ObjectiveText = OBJEKTIV!!!
	LevelText= Ebene
	





  //Quit Panel Text

 QuitText = Verlassen
 QuitDescriptionText = Bist du sicher?
 NoText = Nein
 YesText = ja 


// Settings Panel Text

MusicText = Musik
SoundText = Klingen
SensitivityText = Empfindlichkeit


//Quest Text

AchievementText = Leistung
DailyTaskText = Tägliche Aufgabe
	//Achievement
	EnemyTargetsText = feindliches Ziel
	

	CompleteLevelText= Komplette Stufe


	EnemiesText = der Feind
	

	DailyBonusText = Täglicher Bonus


	TimeText = Zeit
	

	ClearLevelText = klar Stufe
	
	ClearMissionText = Klare Mission



	 EnemyTargetsText = feindliche Ziele



//free spin text

SpinText = Drehen

FreeText = Frei



//shops detail text

GunText = Gewehr
MedicalKitsText = Medizin-Kits
ShieldText = SCHILD
GoldText = das Gold
CashText = Kasse

	//gun detail text

	PistolText = Pistole
	RifleText= Gewehr
	ShotGunText = Schrotflinte
	RPGText = RPG
	SniperText = Scharfschütze
	GrenadeLauncherText = Granatenwerfer

	//GUNS PROPERTIES TEXT
		ClipSizeText= Filmgröße
		DamageText = Beschädigung
		ReloadTimeText = Nachladezeit
		FireRateText= Feuerrate

	//Medical kits

	PacksText = Packungen

	//shield detail text

	HealthText = Gesundheit

	//gold detail text

	CountText = Graf

MissileText =Rakete
AirStrikeText = Luftangriff

EquipText = ausrüsten
EquipedText = AUSGESTATTETES
CollectText = SAMMELN
DayText = TAG
UpgradeText = Aktualisierung
LoadingText = LADE
TapToContinueText = Tap , um fortzufahren
PausedText = pausiert!!!
WatchVideoText = Video ansehen
RestartText = Neustart
StoreText = Geschäft
WatchLevelVideosText = Uhr Stufe Videos
RewardVideoText = Belohnung Video
TopGamesText = TOP -SPIELE
RemoveAdsText = Werbung ausblenden
ClaimText = ANSPRUCH
ClaimedText = BEHAUPTET

OKText = OK
CancelText = Abbrechen
RetryText = Wiederholungs!!!





CongratulationText = Glückwunsch
SniperXText = Scharfschütze X
ContinueText = fortsetzen

LevelCompletedText=Level geschafft!!!
LevelFailedText=Stufe Ausfallen!!!
MissionFailedText= Mission scheitern!!!
MissionCompletedText=Mission abgeschlossen!!!


ObjectiveDescription2Text = Klar In Zielzeit
ObjectiveDescription3Text = Mehr als 50 % Gesundheit