
// Main Menu Detail
MoreGamesText=Più giochi
SettingsText =impostazioni
MoreFunText = Più divertimento
RateUsText = tasso degli Stati Uniti!!!
PlayText = Giocare
ScoreText = Punto
ExitText = Uscita
BackText = Indietro
QuestText = Ricerca
FreeSpinText = rotazione libera

ShopText = Negozio
FreeCashText =libero Contanti
FreeGoldText = libero oro
PrimaryWeaponText = Arma primaria
MissionText = Missione
NextText = Il prossimo
BuyText=Acquistare
MissionSelectionText = SELEZIONE MISSIONE
LevelSelectionText= SELEZIONE LIVELLO


// Extra Button

HomeText=Casa
ResumeText=Curriculum vitae
ReplayText=Replay
ShareText=Condividere
HotGamesText=Giochi Hot
LoadingText=Caricamento in corso
StartRecordingText=Inizia a registrare
StopText=Stop
ShowRecordingText=Mostra di registrazione

//Other Button Text

LevelClearText= livello Cancella
PauseText=Pausa
LevelCompleteText=Livello completato
LevelFailText=livello Fail
MissionFailText= Missione Fail
MissionCompleteText=Missione completata
GameOverText= Gioco finito
SpinTheWheelText=Gira la ruota
	//LEVEL SELECTION DETAIL TEXT

	ObjectiveText = OBBIETTIVO!!!
	LevelText= Livello
	




  //Quit Panel Text

 QuitText = Smettere
 QuitDescriptionText = Sei sicuro?
 NoText = No
 YesText = sì


// Settings Panel Text

MusicText = Musica
SoundText = Suono
SensitivityText = sensibilità


//Quest Text

AchievementText = realizzazione
DailyTaskText = Compito giornaliero
	//Achievement
	EnemyTargetsText = nemico di destinazione
	
	CompleteLevelText= completa il livello
	

	EnemiesText = Nemici
	

	DailyBonusText = Bonus giornaliero
	

	TimeText = Tempo
	

	ClearLevelText = Cancella Livello
	
	ClearMissionText = Cancella Mission
	


	 EnemyTargetsText = obiettivi nemici


//free spin text

SpinText = rotazione

FreeText = Gratuito



//shops detail text

GunText = Pistola
MedicalKitsText =kit medici
ShieldText = SCUDO
GoldText = ORO
CashText = Contanti

	//gun detail text

	PistolText = Pistola
	RifleText= Fucile
	ShotGunText = ShotGun
	RPGText = RPG
	SniperText = Cecchino
	GrenadeLauncherText = Lanciatore di granate

	//GUNS PROPERTIES TEXT
		ClipSizeText= dimensione del filmato
		DamageText = Danno
		ReloadTimeText = Ricarica Tempo
		FireRateText= Fuoco Tasso

	//Medical kits

	PacksText = Pacchetti

	//shield detail text

	HealthText = Salute

	//gold detail text

	CountText = Contare

MissileText = MISSILI
AirStrikeText = attacco aereo
EquipText = EQUIP
EquipedText = ATTREZZATA
CollectText = Raccogli
DayText = GIORNO
UpgradeText = Aggiornamento
LoadingText = CARICAMENTO
TapToContinueText = Selezionare per continuare
PausedText = in pausa!!!
WatchVideoText = Guarda il video
RestartText =Ricomincia
StoreText = negozio
WatchLevelVideosText = Guarda il video di livello
RewardVideoText = Video Ricompensa
TopGamesText = TOP GIOCHI
RemoveAdsText = Rimuovere gli annunci
ClaimText = RECLAMO
ClaimedText = ha sostenuto

OKText = OK
CancelText = Annulla
RetryText = Riprova!!!

CongratulationText=Congratulazione
SniperXText=Cecchino X
ContinueText=proseguire


LevelCompletedText=Livello completato!!!
LevelFailedText=livello fallito!!!
MissionFailedText= Missione fallito!!!
MissionCompletedText=Missione completata!!!


ObjectiveDescription2Text = Cancella In Time di destinazione
ObjectiveDescription3Text = Oltre il 50 % Salute