
// Main Menu Detail



SettingsText =설정
MoreGamesText = 더 많은 게임들
RateUsText = 우리 평가!!!
PlayText = 놀이
ScoreText = 점수
ExitText = 출구
BackText = 뒤로
MoreFunText = 더 재미있는
QuestText = 탐구
FreeSpinText = 무료 스핀
ShopText = 가게
FreeCashText = 무료 현금
FreeGoldText = 무료 골드
PrimaryWeaponText = 기본 무기
MissionText = 사명
NextText = 다음 것
BuyText=사다
MissionSelectionText = 선교 선택
LevelSelectionText= 레벨 선택


// Extra Button

HomeText=집
ResumeText=이력서
ReplayText=다시 하다
ShareText=몫
HotGamesText=인기 게임
LoadingText=로드
StartRecordingText=기록 시작
StopText=중지
ShowRecordingText=쇼 녹화

//Other Button Text

LevelClearText= 레벨 클리어
PauseText=중지
LevelCompleteText=전체 레벨
LevelFailText=레벨 실패
MissionFailText= 미션 실패
MissionCompleteText=미션 완료
GameOverText= 게임 끝
SpinTheWheelText=바퀴 스핀

	//LEVEL SELECTION DETAIL TEXT

	ObjectiveText = 목표!!!
	LevelText= 수평
	





  //Quit Panel Text

 QuitText = 떠나다
 QuitDescriptionText = 확실합니까?
 NoText = 아니
 YesText = 예


// Settings Panel Text

MusicText = 음악
SoundText = 소리
SensitivityText = 감광도


//Quest Text

AchievementText = 성취
DailyTaskText = 매일 작업
	//Achievement
	EnemyTargetsText = 적 대상
	

	CompleteLevelText= 전체 레벨
	

	EnemiesText = 적
	

	DailyBonusText = 매일 보너스


	TimeText = 시각

	ClearLevelText = 클리어 레벨
	

	ClearMissionText = 클리어 미션


	 EnemyTargetsText = 적 대상



//free spin text

SpinText = 회전
FreeText = 비어 있는


//shops detail text

GunText = 총
MedicalKitsText = 의료 키트
ShieldText = 방패
GoldText = 금
CashText = 현금

	//gun detail text

	PistolText = 권총
	RifleText= 소총
	ShotGunText = 산탄 총
	RPGText = RPG
	SniperText = 저격병
	GernadeLaunText = GERNADE LAUN

	//GUNS PROPERTIES TEXT
		ClipSizeText= 클립 크기
		DamageText = 손해
		ReloadTimeText = 새로 고침 시간
		FireRateText= 화재 속도

	//Medical kits

	PacksText = 팩

	//shield detail text

	HealthText = 건강

	//gold detail text

	CountText = 카운트

MissileText = 미사일
AirStrikeText = 공습
EquipText = 갖추어 주다
EquipedText = 장착
CollectText 의 = 수집
DayText = 일
UpgradeText = 업그레이드
LoadingText = 로드
TapToContinueText = 눌러 계속 하려면
PausedText = 일시 중지!!!
WatchVideoText = 동영상보기
RestartText = 다시 시작
StoreText = 스토어
WatchLevelVideosText = 시계 레벨 동영상
RewardVideoText = 보상 동영상
TopGamesText = 상단 게임
RemoveAdsText = 광고를 제거하다
ClaimText = 청구
ClaimedText = 주장
OKText = 그래
CancelText = 취소
RetryText = 재시도!!!

CongratulationText = 축하
SniperXText = 스나이퍼 X
ContinueText = 계속


LevelCompletedText=전체 레벨!!!
LevelFailedText=레벨 실패!!!
MissionFailedText= 미션 실패!!!
MissionCompletedText=미션 완료!!!
ObjectiveDescription2Text = 지우기 에서 목표 시간
ObjectiveDescription3Text = 이상 50 % 건강