
// Main Menu Detail Text

SettingsText =настройки
MoreGamesText = Больше игр
RateUsText = оцените нас!!!
PlayText = Играть
ScoreText = Гол
ExitText = Выход
BackText = назад

MoreFunText = Больше удовольствия

QuestText = поиск
FreeSpinText = Свободное вращение
ShopText = магазин
FreeCashText = Свободный денежный
FreeGoldText = Свободное золото
PrimaryWeaponText = Основное оружие
MissionText = миссия
NextText =следующий
BuyText=купить
MissionSelectionText = МИССИЯ ВЫБОР
LevelSelectionText= ВЫБОР УРОВНЯ


// Extra Button

HomeText=Главная
ResumeText=Продолжить
ReplayText=переигровка
ShareText=Поделиться
HotGamesText=Горячие игры
LoadingText=загрузка
StartRecordingText=Начать запись
StopText=стоп
ShowRecordingText=Показать записи

//Other Button Text

LevelClearText= Уровень Очистить
PauseText=Пауза
LevelCompleteText=Уровень пройден
LevelFailText=Уровень Сбой
MissionFailText= Миссия Сбой
MissionCompleteText=Задание выполнено
GameOverText= Игра закончена
SpinTheWheelText=Крутите колесо


	//LEVEL SELECTION DETAIL TEXT

	ObjectiveText = ЗАДАЧА!!!
	LevelText= уровень






  //Quit Panel Text

 QuitText = Уволиться
 QuitDescriptionText = Ты уверен?
 NoText = Нет
 YesText = да 


// Settings Panel Text

MusicText = Музыка
SoundText = звук
SensitivityText = чувствительность


//Quest Text

AchievementText = Достижение
DailyTaskText = Ежедневное задание
	//Achievement
	EnemyTargetsText = Враг Target


	CompleteLevelText= Полный уровень


	EnemiesText = враги


	DailyBonusText = Ежедневный бонус


	TimeText = Время
	TimeDescription1Text = Play for 20 mints
	

	ClearLevelText = ясно уровень

	ClearMissionText = Очистить Миссия
	



	 EnemyTargetsText = вражеские цели


//free spin text

SpinText = Вращение
FreeText = Свободно


//shops detail text

GunText = пистолет
MedicalKitsText = Медицинские комплекты
ShieldText = ЩИТ
GoldText = ЗОЛОТО
CashText = Денежные средства

	//gun detail text

	PistolText = Пистолет
	RifleText= винтовка
	ShotGunText = Дробовик
	RPGText = RPG
	SniperText = снайпер
	GernadeLaunText = GERNADE LAUN

	//GUNS PROPERTIES TEXT
		ClipSizeText= размер клипа
		DamageText = Наносить ущерб
		ReloadTimeText = Время перезагрузки
		FireRateText= Скорострельность

	//Medical kits

	PacksText = пакеты

	//shield detail text

	HealthText = Здоровье

	//gold detail text

	CountText = подсчитывать

MissileText = РАКЕТЫ
AirStrikeText = авиаудара
EquipText = оснащать
EquipedText = ОБОРУДОВАННАЯ
CollectText = СОБИРАТЬ
DayText = ДЕНЬ
UpgradeText = Обновление
LoadingText = НАГРУЗКИ
TapToContinueText = Чтобы продолжить, нажмите
PausedText = приостановлена!!!
WatchVideoText = Смотреть видео
RestartText = Перезагрузка
StoreText = магазин
WatchLevelVideosText = уровень смотреть видео
RewardVideoText = Награда Видео
TopGamesText = Лучшие игры
RemoveAdsText = Удалить объявления
ClaimText = Запрос
ClaimedText = Формула изобретения

OKText = ОК
CancelText = Отменить
RetryText = Повторить попытку!!!


CongratulationText = ПОЗДРАВЛЕНИЕ
SniperXText = Снайпер X
ContinueText = Продолжить


LevelCompletedText=Уровень пройден!!!
LevelFailedText=Уровень Сбой!!!
MissionFailedText= Миссия Сбой!!!
MissionCompletedText=Задание выполнено!!!


ObjectiveDescription2Text = Чисто В цели Время
ObjectiveDescription3Text = Более 50 % Здоровье