
// Main Menu Detail

MoreGamesText=Daha fazla oyun
SettingsText =Ayarlar
MoreFunText = Daha fazla eğlence
RateUsText = Bizi değerlendirin!!!
PlayText = oyun
ScoreText = Gol
ExitText = çıkış
BackText = Geri
QuestText = arama
FreeSpinText = ücretsiz döndürme
ShopText = Dükkan
FreeCashText = serbest Nakit
FreeGoldText = Ücretsiz Gold
PrimaryWeaponText =birincil Silah
MissionText = Misyon
NextText = Sonraki
BuyText=satın almak
MissionSelectionText = MİSYON SEÇİMİ
LevelSelectionText= SEVİYE SEÇİMİ

// Extra Button

HomeText=ev
ResumeText=Devam et
ReplayText=Tekrar
ShareText=Pay
HotGamesText=sıcak Oyunlar
LoadingText=Yükleniyor
StartRecordingText=Kayda başla
StopText=Dur
ShowRecordingText=göster Kayıt

//Other Button Text

LevelClearText= Seviye temizle
PauseText=durma
LevelCompleteText=Seviye tam
LevelFailText=Seviye başarısız
MissionFailText= Misyon başarısız
MissionCompleteText=Görev tamamlandı
GameOverText= Oyun bitti
SpinTheWheelText=Tekerleği döndür

	//LEVEL SELECTION DETAIL TEXT

	ObjectiveText = AMAÇ!!!
	LevelText= seviye
	





  //Quit Panel Text

 QuitText = çıkmak
 QuitDescriptionText = Emin misiniz?
 NoText = Yok hayır
 YesText = Evet 


// Settings Panel Text

MusicText = Müzik
SoundText = Ses
SensitivityText = Duyarlılık


//Quest Text

AchievementText = Başarı
DailyTaskText = Günlük görev
	//Achievement
	EnemyTargetsText = düşman Hedef


	CompleteLevelText= Komple Seviye


	EnemiesText = Düşmanlar
	

	DailyBonusText = Günlük bonus


	TimeText = Zaman


	ClearLevelText = temizle Seviye


	ClearMissionText = temizle Görev


	 //Daily task


	 EnemyTargetsText = düşman Hedefler
	


//free spin text

SpinText = Çevirmek

FreeText = Ücretsiz



//shops detail text

GunText = tabanca
MedicalKitsText = tıbbi takımlar
ShieldText = Kalkan
GoldText =ALTIN
CashText = Nakit

	//gun detail text

	PistolText = Tabanca
	RifleText= tüfek
	ShotGunText = av tüfeği
	RPGText = RPG
	SniperText = Keskin nisanci
	GrenadeLauncherText = Bomba Atar

	//GUNS PROPERTIES TEXT
		ClipSizeText= klip Boyutu
		DamageText = Hasar vermek
		ReloadTimeText = Tekrar dolum suresi
		FireRateText= Yangın Oranı

	//Medical kits

	PacksText = Paketleri

	//shield detail text

	HealthText = Sağlık

	//gold detail text

	CountText = saymak

MissileText = FÜZELER
AirStrikeText = HAVA GREVİ
EquipText = EQUIP
EquipedText = DONANIMLI
CollectText = TOPLA
DayText = GÜN
UpgradeText = Yükseltme
LoadingText = YÜKLENİYOR
TapToContinueText = dokunun Devam için
PausedText = durdurulmuş!!!
WatchVideoText = Video İzle
RestartText = tekrar başlat
StoreText = Mağaza
WatchLevelVideosText = İzle Seviye Videolar
RewardVideoText = Ödül video
TopGamesText = TOP OYUNLARI
RemoveAdsText = Reklamlar Kaldır
ClaimText = İDDİA
ClaimedText = CLAIMED

OKText = Tamam
CancelText = İptal
RetryText = Yeniden dene!!!

CongratulationText = kutlama
SniperXText = keskin nisanci X
ContinueText = Devam


LevelCompletedText=Seviye tam!!!
LevelFailedText=Seviye başarısız!!!
MissionFailedText= Misyon başarısız!!!
MissionCompletedText=Görev tamamlandı!!!


ObjectiveDescription2Text = Temizle In Hedef Zaman
ObjectiveDescription3Text = Aşırı % 50 Sağlık